#####################################################
#%#%#   #%#                  %    %                %#
# # # # # # #################### ################## #
# # # # # # #                %#  #%                 #
#$# #%# # # # #################  ########### ###### #
# # # # # # #                                    %# #
# # # # # # # ################################## ## #
# # # # # # #  %#####     #    #   # #  # # %#   ## #
# # # #   # # #       # # #  # # # # #  #    #   ## #
# # # #####   ######### # #  # # #      #  ##### ## #
# # #       #           # #  # # # # #  #   %    ## #
# # ####### # ########### #  # # # # #  ######## ## #
# #         #    %           # % #%# #           ## #
# # ####### # ######################## ############ #
#   #%      #  %                                 %# #
#####################################################