###############################
#                             #
#              vv             #
#                             #
#              -!             #
##############    #############
#              ~i             #
#                             #
#              ^^             #
#                             #
#                             #
###############################