###############################
#                             #
#                             #
#                             #
####    #######  ######    ####
#              @              #
#   ###        ##      ####   #
#                             #
#                             #
#                             #
#                             #
###############################